15x15
...............
..I...I.....II.
........I...I..
........I......
...............
...............
.I.I..I.I......
.I.I..I........
...I...I...III.
...............
...I...........
..I....I...I...
I...........I..
..I...I.I....I.
...I...........
