10x10
...I......
.......I..
..........
..I....I..
..........
....I.....
......I...
..........
...I...I..
..........
